var mapData1_1_0 = [
    [ 9,  9,  9,  9,  9,     9,  9,  9,  9,  9,      9,  9,  9,  9,  9,     9,  9,  9,  9,  9,      9,  9,  9,  9,  9,     9,  9,  9,  9,  9],
    [ 9,  9,  9,  9,  9,     9,  9,  9,  9,  9,      9,  9,  9,  9,  9,     9,  9,  9,  9,  9,      9,  9,  9,  9,  9,     9,  9,  9,  9,  9],
    [ 9,  9,  9,  9,  9,     9,  9,  9,  9,  9,      9,  9,  9,  9,  9,     9,  9,  9,  9,  9,      9,  9,  9,  9,  9,     9,  9,  9,  9,  9],
    [ 9,  9,  9,  9,  9,     9,  9,  9,  9,  9,      9,  9,  9,  9,  9,     9,  9,  9,  9,  9,      9,  9,  9,  9,  9,     9,  9,  9,  9,  9],
    [ 9,  9,  9,  9,  9,     9,  9,  9,  9,  9,      9,  9,  9,  9,  9,     9,  9,  9,  9,  9,      9,  9,  9,  9,  9,     9,  9,  9,  9,  9],

    [ 9,  9,  9,  9,  9,     9,  9,  9,  9,  9,      9,  9,  9,  9,  9,     9,  9,  9,  9,  9,      9,  9,  9,  9,  9,     9,  9,  9,  9,  9],
    [ 9,  9,  9,  9,  9,     9,  9,  9,  9,  9,      9,  9,  9,  9,  9,     9,  9,  9,  9,  9,      9,  9,  9,  9,  9,     9,  9,  9,  9,  9],
    [ 9,  9,  9,  9,  9,     9,  9,  9,  9,  9,      9,  9,  9,  9,  9,     9,  9,  9,  9,  9,      9,  9,  9,  9,  9,     9,  9,  9,  9,  9],
    [ 9,  9,  9,  9,  9,     9,  9,  9,  9,  9,      9,  9,  9,  9,  9,     9,  9,  9,  9,  9,      9,  9,  9,  9,  9,     9,  9,  9,  9,  9],
    [ 9,  9,  9,  9,  9,     9,  9,  9,  9,  9,      9,  9,  9,  9,  9,     9,  9,  9,  9,  9,      9,  9,  9,  9,  9,     9,  9,  9,  9,  9],

    [ 9,  9,  9,  9,  9,     9,  9,  9,  9,  9,      9,  9,  9,  9,  9,     9,  9,  9,  9,  9,      9,  9,  9,  9,  9,     9,  9,  9,  9,  9],
    [ 9,  9,  9,  9,  9,     9,  9,  9,  9,  9,      9,  9,  9,  9,  9,     9,  9,  9,  9,  9,      9,  9,  9,  9,  9,     9,  9,  9,  9,  9],
    [ 9,  9,  9,  9,  9,     9,  9,  9,  9,  9,      9,  9,  9,  9,  9,     9,  9,  9,  9,  9,      9,  9,  9,  9,  9,     9,  9,  9,  9,  9],
    [ 9,  9,  9,  9,  9,     9,  9,  9,  9,  9,      9,  9,  9,  9,  9,     9,  9,  9,  9,  9,      9,  9,  9,  9,  9,     9,  9,  9,  9,  9],
    [ 9,  9,  9,  9,  9,     9,  9,  9,  9,  9,      9,  9,  9,  9,  9,     9,  9,  9,  9,  9,      9,  9,  9,  9,  9,     9,  9,  9,  9,  9],

    [ 9,  9,  9,  9,  9,     9,  9,  9,  9,  9,      9,  9,  9,  9,  9,     9,  9,  9,  9,  9,      9,  9,  9,  9,  9,     9,  9,  9,  9,  9],
    [ 9,  9,  9,  9,  9,     9,  9,  9,  9,  9,      9,  9,  9,  9,  9,     9,  9,  9,  9,  9,      9,  9,  9,  9,  9,     9,  9,  9,  9,  9],
    [ 9,  9,  9,  9,  9,     9,  9,  9,  9,  9,      9,  9,  9,  9,  9,     9,  9,  9,  9,  9,      9,  9,  9,  9,  9,     9,  9,  9,  9,  9],
    [ 9,  9,  9,  9,  9,     9,  9,  9,  9,  9,      9,  9,  9,  9,  9,     9,  9,  9,  9,  9,      9,  9,  9,  9,  9,     9,  9,  9,  9,  9],
    [ 9,  9,  9,  9,  9,     9,  9,  9,  9,  9,      9,  9,  9,  9,  9,     9,  9,  9,  9,  9,      9,  9,  9,  9,  9,     9,  9,  9,  9,  9]
];

var mapData1_1_1 = [
    [ 5,  5,  5,  5, 5,      5,  5,  5,  5,  5,      5,  5,  5, 5,  5,     5,  5,   5,  5,  5,     13, 13,  5,  5,  5,     5,  5,  5,  5,  5,],
    [ 5,  5,  5,  5, 5,      5,  5,  5,  5,  5,      5,  5,  5,  5, 5,     5,  5,   5,  5,  5,     13, 13,  5,  5,  5,     5,  5,  5,  5,  5,],
    [10, 10, 10, 10, 10,    10, 10, 10, 10, 10,     10, 10, 10, 10, 10,    10, 10, 10, 10, 10,     10, 10, 10, 10, 10,    10, 10, 10, 10,  3,],
    [10, 10, 10, 10, 10,    10, 10, 10, 10, 10,     10, 10, 10, 10, 10,    10, 10, 10, 10, 10,     10, 10, 10, 10, 10,    10, 10, 10, 10,  3,],
    [10, 10, 10, 10, 10,    10, 10, 10, 10, 10,     10, 10, 10, 10, 10,    10, 10, 10, 10, 10,     10, 10, 10, 10, 10,    10, 10, 10, 10,  3,],

    [10, 10, 10, 10, 10,    10, 10, 10, 10, 10,     10, 10, 10, 10, 10,    10, 10, 10, 10, 10,     10, 10, 10, 10, 10,    10, 10, 10, 10,  3,],
    [10, 10, 10, 10, 10,    10, 10, 10, 10, 10,     10, 10, 10, 10, 10,    10, 10, 10, 10, 10,     10, 10, 10, 10, 10,    10, 10, 10, 10,  3,],
    [10, 10, 10, 10, 10,    10, 10, 10, 10, 10,     10, 10, 10, 10, 10,    10, 10, 10, 15, 15,     10, 10, 15, 15, 10,    10, 10, 10, 10,  3,],
    [10, 10, 10, 10, 10,    10, 10, 10, 10, 10,     10, 10, 10, 10, 10,    10, 10, 10, 15, 15,     10, 10, 15, 15, 10,    10, 10, 10, 10,  3,],
    [10, 10, 10, 10, 10,    10, 10, 10, 10, 10,     10, 10, 10, 10, 10,    10, 10, 10, 10, 10,     10, 10, 10, 10, 10,    10, 10, 10, 10,  3,],

    [10, 10, 10, 10, 10,    10, 10, 10, 10, 10,     10, 10, 10, 10, 10,    10, 10, 10, 10, 10,     10, 10, 10, 10, 10,    10, 10, 10, 10,  3,],
    [10, 10, 10, 10, 10,    10, 10, 10, 10, 10,     10, 10, 10, 10, 10,    10, 10, 10, 10, 10,     10, 10, 10, 10, 10,    10, 10, 10, 10,  3,],
    [10, 10, 10, 10, 10,    10, 10, 10, 10, 10,     10, 10, 10, 10, 10,    10, 10, 10, 10, 10,     10, 10, 10, 10, 10,    10, 10, 10, 10,  3,],
    [10, 10, 10, 10, 10,    10, 10, 10, 10, 10,     10, 10, 10, 10, 10,    10, 10, 10, 10, 10,     10, 10, 10, 10, 10,    10, 10, 10, 10,  3,],
    [10, 10, 10, 10, 10,    10, 10, 10, 10, 10,     10, 10, 10, 10, 10,    10, 10, 10, 10, 10,     10, 10, 10, 10, 10,    10, 10, 10, 10,  3,],

    [10, 10, 10, 10, 10,    10, 10, 10, 10, 10,     10, 10, 10, 10, 10,    10, 10, 10, 10, 10,     10, 10, 10, 10, 10,    10, 10, 10, 10,  3,],
    [10, 10, 10, 10, 10,    10, 10, 10, 10, 10,     10, 10, 10, 10, 10,    10, 10, 10, 10, 10,     10, 10, 10, 10, 10,    10, 10, 10, 10,  3,],
    [10, 10, 10, 10, 10,    10, 10, 10, 10, 10,     10, 10, 10, 10, 10,    10, 10, 10, 10, 10,     10, 10, 10, 10, 10,    10, 10, 10, 10,  3,],
    [-1, -1, -1, -1, -1,    -1, -1, -1, -1, -1,     -1, -1, -1, -1, -1,    -1, -1, -1, -1, -1,     -1, -1, -1, -1, -1,    -1, -1, -1, -1, -1,],
    [-1, -1, -1, -1, -1,    -1, -1, -1, -1, -1,     -1, -1, -1, -1, -1,    -1, -1, -1, -1, -1,     -1, -1, -1, -1, -1,    -1, -1, -1, -1, -1,]
];

var mapData1_1_col = [
    [ 0,  0,  0,  0,  0,     0,  0,  0,  0,  0,      0,  0,  0,  0,  0,     0,  0,  0,  0,  0,      0,  0,  0,  0,  0,     0,  0,  0,  0,  0,],
    [ 1,  1,  1,  1,  1,     1,  1,  1,  1,  1,      1,  1,  1,  1,  1,     1,  1,  1,  1,  1,      1,  1,  1,  1,  1,     1,  1,  1,  1,  1,],
    [ 0,  0,  0,  0,  0,     0,  0,  0,  0,  0,      0,  0,  0,  0,  0,     0,  0,  0,  0,  0,      0,  0,  0,  0,  0,     0,  0,  0,  0,  1,],
    [ 0,  0,  0,  0,  0,     0,  0,  0,  0,  0,      0,  0,  0,  0,  0,     0,  0,  0,  0,  0,      0,  0,  0,  0,  0,     0,  0,  0,  0,  1,],
    [ 0,  0,  0,  0,  0,     0,  0,  0,  0,  0,      0,  0,  0,  0,  0,     0,  0,  0,  0,  0,      0,  0,  0,  0,  0,     0,  0,  0,  0,  1,],

    [ 0,  0,  0,  0,  0,     0,  0,  0,  0,  0,      0,  0,  0,  0,  0,     0,  0,  0,  0,  0,      0,  0,  0,  0,  0,     0,  0,  0,  0,  1,],
    [ 0,  0,  0,  0,  0,     0,  0,  0,  0,  0,      0,  0,  0,  0,  0,     0,  0,  0,  0,  0,      0,  0,  0,  0,  0,     0,  0,  0,  0,  1,],
    [ 0,  0,  0,  0,  0,     0,  0,  0,  0,  0,      0,  0,  0,  0,  0,     0,  0,  0,  0,  0,      0,  0,  0,  0,  0,     0,  0,  0,  0,  1,],
    [ 0,  0,  0,  0,  0,     0,  0,  0,  0,  0,      0,  0,  0,  0,  0,     0,  0,  0,  0,  0,      0,  0,  0,  0,  0,     0,  0,  0,  0,  1,],
    [ 0,  0,  0,  0,  0,     0,  0,  0,  0,  0,      0,  0,  0,  0,  0,     0,  0,  0,  0,  0,      0,  0,  0,  0,  0,     0,  0,  0,  0,  1,],

    [ 0,  0,  0,  0,  0,     0,  0,  0,  0,  0,      0,  0,  0,  0,  0,     0,  0,  0,  0,  0,      0,  0,  0,  0,  0,     0,  0,  0,  0,  1,],
    [ 0,  0,  0,  0,  0,     0,  0,  0,  0,  0,      0,  0,  0,  0,  0,     0,  0,  0,  0,  0,      0,  0,  0,  0,  1,     0,  0,  0,  0,  1,],
    [ 0,  0,  0,  0,  0,     0,  0,  0,  0,  0,      0,  0,  0,  0,  0,     0,  0,  0,  0,  0,      0,  0,  0,  0,  0,     0,  0,  0,  0,  1,],
    [ 0,  0,  0,  0,  0,     0,  0,  0,  0,  0,      0,  0,  0,  0,  0,     0,  0,  0,  0,  0,      0,  0,  0,  0,  0,     0,  0,  0,  0,  1,],
    [ 0,  0,  0,  0,  0,     0,  0,  0,  0,  0,      0,  0,  0,  0,  0,     0,  0,  0,  0,  0,      0,  0,  0,  0,  0,     0,  0,  0,  0,  1,],

    [ 0,  0,  0,  0,  0,     0,  0,  0,  0,  0,      0,  0,  0,  0,  0,     0,  0,  0,  0,  0,      0,  0,  0,  0,  0,     0,  0,  0,  0,  1,],
    [ 0,  0,  0,  0,  0,     0,  0,  0,  0,  0,      0,  0,  0,  0,  0,     0,  0,  0,  0,  0,      0,  0,  0,  0,  0,     0,  0,  0,  0,  1,],
    [ 0,  0,  0,  0,  0,     0,  0,  0,  0,  0,      0,  0,  0,  0,  0,     0,  0,  0,  0,  0,      0,  0,  0,  0,  0,     0,  0,  0,  0,  1,],
    [ 1,  1,  1,  1,  1,     1,  1,  1,  1,  1,      1,  1,  1,  1,  1,     1,  1,  1,  1,  1,      1,  1,  1,  1,  1,     1,  1,  1,  1,  1,],
    [ 0,  0,  0,  0,  0,     0,  0,  0,  0,  0,      0,  0,  0,  0,  0,     0,  0,  0,  0,  0,      0,  0,  0,  0,  0,     0,  0,  0,  0,  0,]
];
