var mapData2_0 = [
    [ 9,  9,  9,  9,  9,     9,  9,  9,  9,  9,      9,  9,  9,  9,  9,     9,  9,  9,  9,  9,      9,  9,  9,  9,  9,     9,  9,  9,  9,  9],
    [ 9,  9,  9,  9,  9,     9,  9,  9,  9,  9,      9,  9,  9,  9,  9,     9,  9,  9,  9,  9,      9,  9,  9,  9,  9,     9,  9,  9,  9,  9],
    [ 9,  9,  9,  9,  9,     9,  9,  9,  9,  9,      9,  9,  9,  9,  9,     9,  9,  9,  9,  9,      9,  9,  9,  9,  9,     9,  9,  9,  9,  9],
    [ 9,  9,  9,  9,  9,     9,  9,  9,  9,  9,      9,  9,  9,  9,  9,     9,  9,  9,  9,  9,      9,  9,  9,  9,  9,     9,  9,  9,  9,  9],
    [ 9,  9,  9,  9,  9,     9,  9,  9,  9,  9,      9,  9,  9,  9,  9,     9,  9,  9,  9,  9,      9,  9,  9,  9,  9,     9,  9,  9,  9,  9],

    [ 9,  9,  9,  9,  9,     9,  9,  9,  9,  9,      9,  9,  9,  9,  9,     9,  9,  9,  9,  9,      9,  9,  9,  9,  9,     9,  9,  9,  9,  9],
    [ 9,  9,  9,  9,  9,     9,  9,  9,  9,  9,      9,  9,  9,  9,  9,     9,  9,  9,  9,  9,      9,  9,  9,  9,  9,     9,  9,  9,  9,  9],
    [ 9,  9,  9,  9,  9,     9,  9,  9,  9,  9,      9,  9,  9,  9,  9,     9,  9,  9,  9,  9,      9,  9,  9,  9,  9,     9,  9,  9,  9,  9],
    [ 9,  9,  9,  9,  9,     9,  9,  9,  9,  9,      9,  9,  9,  9,  9,     9,  9,  9,  9,  9,      9,  9,  9,  9,  9,     9,  9,  9,  9,  9],
    [ 9,  9,  9,  9,  9,     9,  9,  9,  9,  9,      9,  9,  9,  9,  9,     9,  9,  9,  9,  9,      9,  9,  9,  9,  9,     9,  9,  9,  9,  9],

    [ 9,  9,  9,  9,  9,     9,  9,  9,  9,  9,      9,  9,  9,  9,  9,     9,  9,  9,  9,  9,      9,  9,  9,  9,  9,     9,  9,  9,  9,  9],
    [ 9,  9,  9,  9,  9,     9,  9,  9,  9,  9,      9,  9,  9,  9,  9,     9,  9,  9,  9,  9,      9,  9,  9,  9,  9,     9,  9,  9,  9,  9],
    [ 9,  9,  9,  9,  9,     9,  9,  9,  9,  9,      9,  9,  9,  9,  9,     9,  9,  9,  9,  9,      9,  9,  9,  9,  9,     9,  9,  9,  9,  9],
    [ 9,  9,  9,  9,  9,     9,  9,  9,  9,  9,      9,  9,  9,  9,  9,     9,  9,  9,  9,  9,      9,  9,  9,  9,  9,     9,  9,  9,  9,  9],
    [ 9,  9,  9,  9,  9,     9,  9,  9,  9,  9,      9,  9,  9,  9,  9,     9,  9,  9,  9,  9,      9,  9,  9,  9,  9,     9,  9,  9,  9,  9],

    [ 9,  9,  9,  9,  9,     9,  9,  9,  9,  9,      9,  9,  9,  9,  9,     9,  9,  9,  9,  9,      9,  9,  9,  9,  9,     9,  9,  9,  9,  9],
    [ 9,  9,  9,  9,  9,     9,  9,  9,  9,  9,      9,  9,  9,  9,  9,     9,  9,  9,  9,  9,      9,  9,  9,  9,  9,     9,  9,  9,  9,  9],
    [ 9,  9,  9,  9,  9,     9,  9,  9,  9,  9,      9,  9,  9,  9,  9,     9,  9,  9,  9,  9,      9,  9,  9,  9,  9,     9,  9,  9,  9,  9],
    [ 9,  9,  9,  9,  9,     9,  9,  9,  9,  9,      9,  9,  9,  9,  9,     9,  9,  9,  9,  9,      9,  9,  9,  9,  9,     9,  9,  9,  9,  9],
    [ 9,  9,  9,  9,  9,     9,  9,  9,  9,  9,      9,  9,  9,  9,  9,     9,  9,  9,  9,  9,      9,  9,  9,  9,  9,     9,  9,  9,  9,  9]
];


var mapData2_1 = [
    [ 5,  5,  5,  5, 5,      5,  5,  5,  5,  5,      5,  5,  5, 5,  5,     5,  5,   5,  5,  5,     14, 14,  5,  5,  5,     5,  5,  5,  5,  5,],
    [ 5,  5,  5,  5, 5,      5,  5,  5,  5,  5,      5,  5,  5,  5, 5,     5,  5,   5,  5,  5,     14, 14,  5,  5,  5,     5,  5,  5,  5,  5,],
    [10, 10, 10, 10, 10,    10, 10, 10, 10, 10,     10, 10, 10, 10, 10,    10, 10, 10, 10, 10,     10, 10, 10, 10, 10,    10, 10, 10, 10, 10,],
    [10, 10, 10, 10, 10,    10, 10, 10, 10, 10,     10, 10, 10, 10, 10,    10, 10, 10, 10, 10,     10, 10, 10, 10, 10,    10, 10, 10, 10, 10,],
    [10, 10, 10, 10, 10,    10, 10, 10, 10, 10,     10, 10, 10, 10, 10,    10, 10, 10, 10, 10,     10, 10, 10, 10, 10,    10, 10, 10, 10, 10,],

    [10, 10, 10, 10, 10,    10, 10, 10, 10, 10,     10, 10, 10, 10, 10,    10, 10, 10, 10, 10,     10, 10, 10, 10, 10,    10, 10, 10, 10, 10,],
    [10, 10, 10, 10, 10,    10, 10, 10, 10, 10,     10, 10, 10, 10, 10,    10, 10, 10, 10, 10,     10, 10, 10, 10, 10,    10, 10, 10, 10, 10,],
    [10, 10, 10, 10, 10,    10, 10, 10, 10, 10,     10, 10, 10, 10, 10,    10, 10, 10, 15, 15,     10, 10, 15, 15, 10,    10, 10, 10, 10, 10,],
    [10, 10, 10, 10, 10,    10, 10, 10, 10, 10,     10, 10, 10, 10, 10,    10, 10, 10, 15, 15,     10, 10, 15, 15, 10,    10, 10, 10, 10, 10,],
    [10, 10, 10, 10, 10,    10, 10, 10, 10, 10,     10, 10, 10, 10, 10,    10, 10, 10, 10, 10,     10, 10, 10, 10, 10,    10, 10, 10, 10, 10,],

    [10, 10, 10, 10, 10,    10, 10, 10, 10, 10,     10, 10, 10, 10, 10,    10, 10, 10, 10, 10,     10, 10, 10, 10, 10,    10, 10, 10, 10, 10,],
    [10, 10, 10, 10, 10,    10, 10, 10, 10, 10,     10, 10, 10, 10, 10,    10, 10, 10, 10, 10,     10, 10, 10, 10, 10,    10, 10, 10, 10, 10,],
    [10, 10, 10, 10, 10,    10, 10, 10, 10, 10,     10, 10, 10, 10, 10,    10, 10, 10, 10, 10,     10, 10, 10, 10, 10,    10, 10, 10, 10, 10,],
    [10, 10, 10, 10, 10,    10, 10, 10, 10, 10,     10, 10, 10, 10, 10,    10, 10, 10, 10, 10,     10, 10, 10, 10, 10,    10, 10, 10, 10, 10,],
    [10, 10, 10, 10, 10,    10, 10, 10, 10, 10,     10, 10, 10, 10, 10,    10, 10, 10, 10, 10,     10, 10, 10, 10, 10,    10, 10, 10, 10, 10,],

    [10, 10, 10, 10, 10,    10, 10, 10, 10, 10,     10, 10, 10, 10, 10,    10, 10, 10, 10, 10,     10, 10, 10, 10, 10,    10, 10, 10, 10, 10,],
    [10, 10, 10, 10, 10,    10, 10, 10, 10, 10,     10, 10, 10, 10, 10,    10, 10, 10, 10, 10,     10, 10, 10, 10, 10,    10, 10, 10, 10, 10,],
    [10, 10, 10, 10, 10,    10, 10, 10, 10, 10,     10, 10, 10, 10, 10,    10, 10, 10, 10, 10,     10, 10, 10, 10, 10,    10, 10, 10, 10, 10,],
    [-1, -1, -1, -1, -1,    -1, -1, -1, -1, -1,     -1, -1, -1, -1, -1,    -1, -1, -1, -1, -1,     -1, -1, -1, -1, -1,    -1, -1, -1, -1, -1,],
    [-1, -1, -1, -1, -1,    -1, -1, -1, -1, -1,     -1, -1, -1, -1, -1,    -1, -1, -1, -1, -1,     -1, -1, -1, -1, -1,    -1, -1, -1, -1, -1,]
];

var mapData2_col = [
    [ 0,  0,  0,  0,  0,     0,  0,  0,  0,  0,      0,  0,  0,  0,  0,     0,  0,  0,  0,  0,      1,  1,  0,  0,  0,     0,  0,  0,  0,  0,],
    [ 1,  1,  1,  1,  1,     1,  1,  1,  1,  1,      1,  1,  1,  1,  1,     1,  1,  1,  1,  1,      0,  0,  1,  1,  1,     1,  1,  1,  1,  1,],
    [ 0,  0,  0,  0,  0,     0,  0,  0,  0,  0,      0,  0,  0,  0,  0,     0,  0,  0,  0,  0,      0,  0,  0,  0,  0,     0,  0,  0,  0,  0,],
    [ 0,  0,  0,  0,  0,     0,  0,  0,  0,  0,      0,  0,  0,  0,  0,     0,  0,  0,  0,  0,      0,  0,  0,  0,  0,     0,  0,  0,  0,  0,],
    [ 0,  0,  0,  0,  0,     0,  0,  0,  0,  0,      0,  0,  0,  0,  0,     0,  0,  0,  0,  0,      0,  0,  0,  0,  0,     0,  0,  0,  0,  0,],

    [ 0,  0,  0,  0,  0,     0,  0,  0,  0,  0,      0,  0,  0,  0,  0,     0,  0,  0,  0,  0,      0,  0,  0,  0,  0,     0,  0,  0,  0,  0,],
    [ 0,  0,  0,  0,  0,     0,  0,  0,  0,  0,      0,  0,  0,  0,  0,     0,  0,  0,  0,  0,      0,  0,  0,  0,  0,     0,  0,  0,  0,  0,],
    [ 0,  0,  0,  0,  0,     0,  0,  0,  0,  0,      0,  0,  0,  0,  0,     0,  0,  0,  0,  0,      0,  0,  0,  0,  0,     0,  0,  0,  0,  0,],
    [ 0,  0,  0,  0,  0,     0,  0,  0,  0,  0,      0,  0,  0,  0,  0,     0,  0,  0,  0,  0,      0,  0,  0,  0,  0,     0,  0,  0,  0,  0,],
    [ 0,  0,  0,  0,  0,     0,  0,  0,  0,  0,      0,  0,  0,  0,  0,     0,  0,  0,  0,  0,      0,  0,  0,  0,  0,     0,  0,  0,  0,  0,],

    [ 0,  0,  0,  0,  0,     0,  0,  0,  0,  0,      0,  0,  0,  0,  0,     0,  0,  0,  0,  0,      0,  0,  0,  0,  0,     0,  0,  0,  0,  0,],
    [ 0,  0,  0,  0,  0,     0,  0,  0,  0,  0,      0,  0,  0,  0,  0,     0,  0,  0,  0,  0,      0,  0,  0,  0,  0,     0,  0,  0,  0,  0,],
    [ 0,  0,  0,  0,  0,     0,  0,  0,  0,  0,      0,  0,  0,  0,  0,     0,  0,  0,  0,  0,      0,  0,  0,  0,  0,     0,  0,  0,  0,  0,],
    [ 0,  0,  0,  0,  0,     0,  0,  0,  0,  0,      0,  0,  0,  0,  0,     0,  0,  0,  0,  0,      0,  0,  0,  0,  0,     0,  0,  0,  0,  0,],
    [ 0,  0,  0,  0,  0,     0,  0,  0,  0,  0,      0,  0,  0,  0,  0,     0,  0,  0,  0,  0,      0,  0,  0,  0,  0,     0,  0,  0,  0,  0,],

    [ 0,  0,  0,  0,  0,     0,  0,  0,  0,  0,      0,  0,  0,  0,  0,     0,  0,  0,  0,  0,      0,  0,  0,  0,  0,     0,  0,  0,  0,  0,],
    [ 0,  0,  0,  0,  0,     0,  0,  0,  0,  0,      0,  0,  0,  0,  0,     0,  0,  0,  0,  0,      0,  0,  0,  0,  0,     0,  0,  0,  0,  0,],
    [ 0,  0,  0,  0,  0,     0,  0,  0,  0,  0,      0,  0,  0,  0,  0,     0,  0,  0,  0,  0,      0,  0,  0,  0,  0,     0,  0,  0,  0,  0,],
    [ 1,  1,  1,  1,  1,     1,  1,  1,  1,  1,      1,  1,  1,  1,  1,     1,  1,  1,  1,  1,      1,  1,  1,  1,  1,     1,  1,  1,  1,  1,],
    [ 0,  0,  0,  0,  0,     0,  0,  0,  0,  0,      0,  0,  0,  0,  0,     0,  0,  0,  0,  0,      0,  0,  0,  0,  0,     0,  0,  0,  0,  0,]
];
