

var mapData1_0 = [
    [ 9,  9,  9,  9,  9,     9,  9,  9,  9,  9,      9,  9,  9,  9,  9,     9,  9,  9,  9,  9,      9,  9,  9,  9,  9,     9,  9,  9,  9,  9],
    [ 9,  9,  9,  9,  9,     9,  9,  9,  9,  9,      9,  9,  9,  9,  9,     9,  9,  9,  9,  9,      9,  9,  9,  9,  9,     9,  9,  9,  9,  9],
    [ 9,  9,  9,  9,  9,     9,  9,  9,  9,  9,      9,  9,  9,  9,  9,     9,  9,  9,  9,  9,      9,  9,  9,  9,  9,     9,  9,  9,  9,  9],
    [ 9,  9,  9,  9,  9,     9,  9,  9,  9,  9,      9,  9,  9,  9,  9,     9,  9,  9,  9,  9,      9,  9,  9,  9,  9,     9,  9,  9,  9,  9],
    [ 9,  9,  9,  9,  9,     9,  9,  9,  9,  9,      9,  9,  9,  9,  9,     9,  9,  9,  9,  9,      9,  9,  9,  9,  9,     9,  9,  9,  9,  9],

    [ 9,  9,  9,  9,  9,     9,  9,  9,  9,  9,      9,  9,  9,  9,  9,     9,  9,  9,  9,  9,      9,  9,  9,  9,  9,     9,  9,  9,  9,  9],
    [ 9,  9,  9,  9,  9,     9,  9,  9,  9,  9,      9,  9,  9,  9,  9,     9,  9,  9,  9,  9,      9,  9,  9,  9,  9,     9,  9,  9,  9,  9],
    [ 9,  9,  9,  9,  9,     9,  9,  9,  9,  9,      9,  9,  9,  9,  9,     9,  9,  9,  9,  9,      9,  9,  9,  9,  9,     9,  9,  9,  9,  9],
    [ 9,  9,  9,  9,  9,     9,  9,  9,  9,  9,      9,  9,  9,  9,  9,     9,  9,  9,  9,  9,      9,  9,  9,  9,  9,     9,  9,  9,  9,  9],
    [ 9,  9,  9,  9,  9,     9,  9,  9,  9,  9,      9,  9,  9,  9,  9,     9,  9,  9,  9,  9,      9,  9,  9,  9,  9,     9,  9,  9,  9,  9],

    [ 9,  9,  9,  9,  9,     9,  9,  9,  9,  9,      9,  9,  9,  9,  9,     9,  9,  9,  9,  9,      9,  9,  9,  9,  9,     9,  9,  9,  9,  9],
    [ 9,  9,  9,  9,  9,     9,  9,  9,  9,  9,      9,  9,  9,  9,  9,     9,  9,  9,  9,  9,      9,  9,  9,  9,  9,     9,  9,  9,  9,  9],
    [ 9,  9,  9,  9,  9,     9,  9,  9,  9,  9,      9,  9,  9,  9,  9,     9,  9,  9,  9,  9,      9,  9,  9,  9,  9,     9,  9,  9,  9,  9],
    [ 9,  9,  9,  9,  9,     9,  9,  9,  9,  9,      9,  9,  9,  9,  9,     9,  9,  9,  9,  9,      9,  9,  9,  9,  9,     9,  9,  9,  9,  9],
    [ 9,  9,  9,  9,  9,     9,  9,  9,  9,  9,      9,  9,  9,  9,  9,     9,  9,  9,  9,  9,      9,  9,  9,  9,  9,     9,  9,  9,  9,  9],

    [ 9,  9,  9,  9,  9,     9,  9,  9,  9,  9,      9,  9,  9,  9,  9,     9,  9,  9,  9,  9,      9,  9,  9,  9,  9,     9,  9,  9,  9,  9],
    [ 9,  9,  9,  9,  9,     9,  9,  9,  9,  9,      9,  9,  9,  9,  9,     9,  9,  9,  9,  9,      9,  9,  9,  9,  9,     9,  9,  9,  9,  9],
    [ 9,  9,  9,  9,  9,     9,  9,  9,  9,  9,      9,  9,  9,  9,  9,     9,  9,  9,  9,  9,      9,  9,  9,  9,  9,     9,  9,  9,  9,  9],
    [ 9,  9,  9,  9,  9,     9,  9,  9,  9,  9,      9,  9,  9,  9,  9,     9,  9,  9,  9,  9,      9,  9,  9,  9,  9,     9,  9,  9,  9,  9],
    [ 9,  9,  9,  9,  9,     9,  9,  9,  9,  9,      9,  9,  9,  9,  9,     9,  9,  9,  9,  9,      9,  9,  9,  9,  9,     9,  9,  9,  9,  9]
];

var mapData1_1 = [
    [ 5,  5,  5,  5, 5,      5,  5,  5,  5,  5,      5,  5,  5, 5,  5,     5,  5,   5,  5,  5,     14, 14,  5,  5,  5,     5,  5,  5,  5,  5,],
    [ 5,  5,  5,  5, 5,      5,  5,  5,  5,  5,      5,  5,  5,  5, 5,     5,  5,   5,  5,  5,     14, 14,  5,  5,  5,     5,  5,  5,  5,  5,],
    [10, 10, 10, 10, 10,    10, 10, 10, 10, 10,     10, 10, 10, 10, 10,    10, 10, 10, 10, 10,     10, 10, 10, 10, 10,    10, 10, 10, 10, 10,],
    [10, 10, 10, 10, 10,    10, 10, 10, 10, 10,     10, 10, 10, 10, 10,    10, 10, 10, 10, 10,     10, 10, 10, 10, 10,    10, 10, 10, 10, 10,],
    [10, 10, 10, 10, 10,    10, 10, 10, 10, 10,     10, 10, 10, 10, 10,    10, 10, 10, 10, 10,     10, 10, 10, 10, 10,    10, 10, 10, 10, 10,],

    [10, 10, 10, 10, 10,    10, 10, 10, 10, 10,     10, 10, 10, 10, 10,    10, 10, 10, 10, 10,     10, 10, 10, 10, 10,    10, 10, 10, 10, 10,],
    [10, 10, 10, 10, 10,    10, 10, 10, 10, 10,     10, 10, 10, 10, 10,    10, 10, 10, 10, 10,     10, 10, 10, 10, 10,    10, 10, 10, 10, 10,],
    [ 4,  4,  4,  4,  4,     4,  4,  4,  4,  4,      4,  4,  4,  4,  4,     4,  4,  4, 15, 15,      4,  4, 15, 15,  3,    10, 10, 10, 10,  3,],
    [-1, -1, -1, -1, -1,    -1, -1, -1, -1, -1,     -1, -1, -1, -1, -1,    -1, -1, -1, 15, 15,     -1, -1, 15, 15,  3,    10, 10, 10, 10,  3,],
    [-1, -1, -1, -1, -1,    -1, -1, -1, -1, -1,     -1, -1, -1, -1, -1,    -1, -1,  -1, -1, -1,    -1, -1, -1, -1,  3,    10, 10, 10, 10,  3,],

    [-1, -1, -1, -1, -1,    -1, -1, -1, -1, -1,     -1, -1, -1, -1, -1,    -1, -1, -1, -1, -1,     -1, -1, -1, -1,  3,    10, 10, 10, 10,  3,],
    [-1, -1, -1, -1, -1,    -1, -1, -1, -1, -1,     -1, -1, -1, -1, -1,    -1, -1, -1, -1, -1,     -1, -1, -1, -1,  3,    10, 10, 10, 10,  3,],
    [ 4,  4,  4,  4,  4,     4,  4,  4,  4,  4,      4,  4,  4,  4,  4,     4,  4,  4,  4,  4,      4,  4,  4,  4,  3,    10, 10, 10, 10,  3,],
    [10, 10, 10, 10, 10,    10, 10, 10, 10, 10,     10, 10, 10, 10, 10,    10, 10, 10, 10, 10,     10, 10, 10, 10, 10,    10, 10, 10, 10, 10,],
    [10, 10, 10, 10, 10,    10, 10, 10, 10, 10,     10, 10, 10, 10, 10,    10, 10, 10, 10, 10,     10, 10, 10, 10, 10,    10, 10, 10, 10, 10,],

    [10, 10, 10, 10, 10,    10, 10, 10, 10, 10,     10, 10, 10, 10, 10,    10, 10, 10, 10, 10,     10, 10, 10, 10, 10,    10, 10, 10, 10, 10,],
    [10, 10, 10, 10, 10,    10, 10, 10, 10, 10,     10, 10, 10, 10, 10,    10, 10, 10, 10, 10,     10, 10, 10, 10, 10,    10, 10, 10, 10, 10,],
    [10, 10, 10, 10, 10,    10, 10, 10, 10, 10,     10, 10, 10, 10, 10,    10, 10, 10, 10, 10,     10, 10, 10, 10, 10,    10, 10, 10, 10, 10,],
    [-1, -1, -1, -1, -1,    -1, -1, -1, -1, -1,     -1, -1, -1, -1, -1,    -1, -1, -1, -1, -1,     -1, -1, -1, -1, -1,    -1, -1, -1, -1, -1,],
    [-1, -1, -1, -1, -1,    -1, -1, -1, -1, -1,     -1, -1, -1, -1, -1,    -1, -1, -1, -1, -1,     -1, -1, -1, -1, -1,    -1, -1, -1, -1, -1,]
];

var mapData1_col = [
    [ 0,  0,  0,  0,  0,     0,  0,  0,  0,  0,      0,  0,  0,  0,  0,     0,  0,  0,  0,  0,      0,  0,  0,  0,  0,     0,  0,  0,  0,  0,],
    [ 1,  1,  1,  1,  1,     1,  1,  1,  1,  1,      1,  1,  1,  1,  1,     1,  1,  1,  1,  1,      1,  1,  1,  1,  1,     1,  1,  1,  1,  1,],
    [ 0,  0,  0,  0,  0,     0,  0,  0,  0,  0,      0,  0,  0,  0,  0,     0,  0,  0,  0,  0,      0,  0,  0,  0,  0,     0,  0,  0,  0,  0,],
    [ 0,  0,  0,  0,  0,     0,  0,  0,  0,  0,      0,  0,  0,  0,  0,     0,  0,  0,  0,  0,      0,  0,  0,  0,  0,     0,  0,  0,  0,  0,],
    [ 0,  0,  0,  0,  0,     0,  0,  0,  0,  0,      0,  0,  0,  0,  0,     0,  0,  0,  0,  0,      0,  0,  0,  0,  0,     0,  0,  0,  0,  0,],

    [ 0,  0,  0,  0,  0,     0,  0,  0,  0,  0,      0,  0,  0,  0,  0,     0,  0,  0,  0,  0,      0,  0,  0,  0,  0,     0,  0,  0,  0,  0,],
    [ 0,  0,  0,  0,  0,     0,  0,  0,  0,  0,      0,  0,  0,  0,  0,    0,  0,  0,  0,  0,     0,  0,  0,  0,  0,    0,  0,  0,  0,  0,],
    [ 1,  1,  1,  1,  1,     1,  1,  1,  1,  1,      1,  1,  0,  1,  1,     1,  1,  1,  0,  0,      1,  1,  0,  0,  1,     0,  0,  0,  0,  1,],
    [ 0,  0,  0,  0,  0,     0,  0,  0,  0,  0,      0,  0,  0,  0,  0,     0,  0,  1,  0,  0,      1,  1,  0,  0,  1,     0,  0,  0,  0,  1,],
    [ 0,  0,  0,  0,  0,     0,  0,  0,  0,  0,      0,  0,  0,  0,  0,     0,  0,  1,  1,  1,      1,  1,  1,  1,  1,     0,  0,  0,  0,  1,],

    [ 0,  0,  0,  0,  0,     0,  0,  0,  0,  0,      0,  0,  0,  0,  0,     0,  0,  1,  1,  1,      1,  1,  1,  1,  1,     0,  0,  0,  0,  1,],
    [ 0,  0,  0,  0,  0,     0,  0,  0,  0,  0,      0,  0,  0,  0,  0,     0,  0,  0,  0,  0,      0,  0,  0,  0,  1,     0,  0,  0,  0,  1,],
    [ 1,  1,  1,  1,  1,     1,  1,  1,  1,  1,      1,  1,  1,  1,  1,     1,  1,  1,  1,  1,      1,  1,  1,  1,  1,     0,  0,  0,  0,  1,],
    [ 0,  0,  0,  0,  0,     0,  0,  0,  0,  0,      0,  0,  0,  0,  0,     0,  0,  0,  0,  0,      0,  0,  0,  0,  0,     0,  0,  0,  0,  0,],
    [ 0,  0,  0,  0,  0,     0,  0,  0,  0,  0,      0,  0,  0,  0,  0,     0,  0,  0,  0,  0,      0,  0,  0,  0,  0,     0,  0,  0,  0,  0,],

    [ 0,  0,  0,  0,  0,     0,  0,  0,  0,  0,      0,  0,  0,  0,  0,     0,  0,  0,  0,  0,      0,  0,  0,  0,  0,     0,  0,  0,  0,  0,],
    [ 0,  0,  0,  0,  0,     0,  0,  0,  0,  0,      0,  0,  0,  0,  0,     0,  0,  0,  0,  0,      0,  0,  0,  0,  0,     0,  0,  0,  0,  0,],
    [ 0,  0,  0,  0,  0,     0,  0,  0,  0,  0,      0,  0,  0,  0,  0,     0,  0,  0,  0,  0,      0,  0,  0,  0,  0,     0,  0,  0,  0,  0,],
    [ 1,  1,  1,  1,  1,     1,  1,  1,  1,  1,      1,  1,  1,  1,  1,     1,  1,  1,  1,  1,      1,  1,  1,  1,  1,     1,  1,  1,  1,  1,],
    [ 0,  0,  0,  0,  0,     0,  0,  0,  0,  0,      0,  0,  0,  0,  0,     0,  0,  0,  0,  0,      0,  0,  0,  0,  0,     0,  0,  0,  0,  0,]
];
